10 10 21 20
0  2  0  0  0  4  0 0  0  -1  
S -1 -1 -1 -1  0  0 -1  0 -1 
0  0  3  0 -1 -1  0 -1  0  0  
0 -1 -1  0 -1  0  0 -1  0 -1  
3 -1 -1  0 -1 -1  0 -1  5 -1 
0  0  0  4  0  0  0  0  0  0 
0 -1 -1  0  0 -1  0 -1  0  G  
0  0  2  0  0  0 -1  0  0 -1  
-1 -1 -1 -1  0  4  0  0 -1 -1
0 -1  0  0 -1  0 -1 -1 -1  0