7 9 40 20
-1 -1 -1 -1 -1 -1 -1 -1 -1
0 0 0 2 0 3 0 0 0
0 0 0 -1 0 -1 0 0 0
S 0 0 -1 -1 -1 0 0 G
0 0 0 0 -1 0 0 0 0
0 0 0 0 6 0 0 0 0
-1 -1 -1 -1 -1 -1 -1 -1 -1