10 20 40 20
0  0 -1  0  0  0  0 -1  0  0  0  0  0  0  0  0  0  0  0  0
 0 -1  2  0 -1  0  0 -1  0 -1  0  0 -1  0  0  0  0  0  0  0
 0  0  1  0 -1 -1  S  0  3  0  0  0  0  0  0  0  0 -1 -1  1
-1 -1  0  0  0 -1 -1  0  0  0  0  0  0 -1  0  0 -1  0  0  0
 0 -1  0 -1  0  0  0 -1  0  0  0  0  0  0  0  5 -1  0  0  G
 0  0  0 -1 -1 -1  0  5  0  0  0  0  0  0 -1  0  0  0  0 -1
-1 -1  0  0 -1 -1  0  0  0  0  0 -1  0  0  0  4  0 -1  0  0
 0  0  0 -1  0  0  0 -1  0  0  0  0  0  0  0 -1  0 -1  0  0
 0 -1 -1  0  0  0  0  0 -1  0  0  0 -1  0  0  0 -1  0 -1 -1
 0  0  0  0 -1 -1  0  0  0 -1  0  0  0  0  0  0  0 -1  0  0