10 20 40 20
 0  0 -1  0  0  2  0  0  0  4  0 -1  0  0  2  0  0 -1  0  0
 0 -1  2  0  S -1  0  0 -1  0  0 -1  0 -1  0  0  0  0  0 -1
-1 -1  0 -1  0  0  3  0 -1  0  0 -1  0  0  0 -1  3 -1  0  0
 0  0  0 -1  3 -1 -1  0 -1  0  0 -1  0 -1  0  0  0 -1  0 -1
 0 -1 -1  0  0  0 -1  0 -1 -1  0  0  0  8 -1  0  0  2  0  0
 0  0 -1  0 -1  0  0  4  0  0  0  0  0  0 -1  0 -1  0 -1  0
-1  0  0  0  0 -1 -1  0  0 -1  0 -1  0  G  0  6  0  0  0 -1
 0 -1  0 -1 -1  0  0  0  0  0 -1  0  0 -1  0  0  0 -1  0 -1
 0 -1  5 -1  0  0  0 -1  0  4  0  0  0  0 -1  0  0 -1  0  0
 S  0  0 -1  0  0  0  0 -1  0 -1 -1  0 -1  0 -1  0  0  0 -1