10 20 10 20
0  0  0  0  0  0  0  0  0  0  0  0  0 -1 -1  0  0  0  0  0
0  0 -1 -1  0 -1 -1  0  0  0  0  0  0  0 -1  0  0  0  0  0
0  0  4  0  0 -1  S -1 -1  0  0  0  0 -1  0  0 -1  0  0  0
0 -1  3 -1  0 -1  0  0  0  0  0  0  0  0  8  0 -1  0  0  0
0 -1  2 -1  5  7  0 -1 -1  0  0  0  0 -1  4 -1  0  0  0  0
0  0  9 -1 -1 -1 -1  5  0  0  0  0  0  0  3  0  0 -1  0 -1
-1 -1  4  0  1  6  0  0 -1  0  0  0  0 -1  8  0  0  0  0  0
0  0  0 -1 -1 -1  0  0 -1  0  0  0  0 -1  7 -1  0  0  0  0
0 -1 -1  0  0  0  0  0 -1  0  0  0  0  0  6  0  0  0 -1  G
0  0  0  0 -1 -1  0  0  0  0  0  0  0  0  0  2 -1  0  0  0