10 10 21 20
  0  2  0  0  0  4  0 -1  0  0  
  S -1  0  0 -1  0  0 -1  0 -1 
  0  0  3  0 -1  0  0 -1  0  0  
  3 -1 -1  0 -1  0  0 -1  0 -1  
  0  0 -1  0 -1 -1  0  0  0  8 
 -1  0  0  4  0  0  0  0  0  0 
  0 -1 -1  0  0 -1  0 -1  0  G  
 -1  0  0  0  0  0 -1  0  0 -1  
  0  0  0 -1  0  4  0  0  0  0 
  0  0  0  0 -1  0 -1 -1  0 -1  