10 20 40 20
 0  0 -1  0  0  0  0  0  0  0  0  0  0  0  0  0  0  0 -1  0
 0 -1 -1  0 -1  0  0  0  0  0  0  0  0 -1 -1  0 -1  0  0  0
 0  0  1  0  0 -1  S  0 -1 -1  0  0  0  0  0  0  0 -1  0  0
 0 -1  0 -1  0  0  0  0 -1  0  0  0 -1 -1  0  0  0  0  0  0
 0  0  0 -1  0  3  0  0  0  0  0  0  0  0  2  0 -1  0  0  0
 0 -1  0 -1 -1 -1 -1  5  0  0  0  0  0  0  0  0  0 -1  0 -1
-1 -1  0  0  1  6  0  0  0  0  0  0  0 -1  7  0  0  0  0  0
 0  0  0 -1 -1 -1  0  0 -1  0  0  0  0  0  0  0  0  0  0  0
 0 -1 -1  0  0  0  0  0 -1  0  0  0  0  0  0  0  0  0 -1  G
 0  0  0  0 -1 -1  0  0  0  0  0  0  0  0  0  2 -1  0  0  0
 