10 20 40 20
 0 -1  0  0  0 -1  0  0  0 -1  0  0  0  0  0  0  0 -1  0 -1
 0 -1  2  0  0 -1  0  0 -1  0  0  0  0 -1  0  0 -1  0  0 -1
-1 -1  0 -1  0  0  G  0 -1  0  0  0  0  0  0 -1  0  0  0  0
 0  0  0 -1  -1  3 -1  0  0  -1  0  0  0 -1  0  0  0  0  0 -1
-1 -1 -1  0  0  0 -1  0  0 -1  0  0  -1  0  0 -1  0  0  0  0
 0  0 -1  0 -1  0  2  8  -1 -1 -1  0  0  0  0  0 -1  0 -1  0
-1  0  0  0  0 -1  0  0  0 -1  0 -1  0  0  0  0 -1  0  0  0
 0 -1  0 -1 -1  0  0  0  0  0 -1  0  0 -1  0  0 -1  0  0  0
 0 -1  5 -1  0  0  0 -1  0  0  0  0  0  S  0  0  0 -1  0  0
 0  0  0 -1  0  0  0  0 -1  0 -1  0  0 -1  0 -1  0  0  0 -1