10 10 26 15
S 0 0 0 0 0 0 0 0 0
0 -1 -1 0 -1 -1 0 0 0 0
0 0 0 0 0 -1 0 0 -1 0
0 -1 0 -1 0 -1 0 0 0 F3
0 -1 0 -1 0 0 0 -1 -1 -1
0 0 0 -1 -1 0 -1 0 0 0
0 -1 0 -1 0 0 0 0 -1 0
0 0 0 -1 -1 -1 0 0 -1 0
0 -1 -1 0 F1 0 5 0 -1 0
0 0 0 0 -1 0 F15 0 0 G