10 10 21 20
0  -1  0  0  0  -1  0 -1  0  0  
S -1  0  0 -1  0  0 -1  0 -1 
0  0  0  0 -1  0  0 -1  0  0  
0 -1 -1  0 -1  0  0 -1  0 -1  
0  0 -1  0 -1 -1  0  0  0  -1 
-1  0  0  0  0  0  0  0  0  0 
0 -1 -1  0  0 -1  0 -1  0  G  
-1  0  0  0  0  0 -1  0  0 -1  
0  0  0 -1  0  -1  0  0  0  0 
0  0  0  0 -1  0 -1 -1  0 -1  